matrix = [
[39,32,32,32,32,32,32,32,32,45],
[19,87,87,87,87,87,87,87,87,135],
[87,87,87,87,87,87,87,87,87,135],
[87,87,87,87,87,87,87,87,87,135],
[148,87,87,87,87,87,87,87,87,135],
[135,87,87,87,87,87,87,87,87,135],
[135,108,108,108,108,108,99,112,108,135],
[135,159,133,133,133,133,125,138,17,135],
[52,32,32,32,32,32,32,32,32,58],
]